%%%%%%%
%     %
% %%% %
% %   %
% %%% %
%     %
%%%%%%%
